--------------------------------------------------
--------------------------------------------------
--------------------------------------#----T------
------------------------T-------------#------T----
--------------------------------------############
T-------------------------------------#-----------
####----------------------------------#-----------
----------------T---------------------#-----------
--------------------------------------#-----------
--------------------------------------#------L----
----###################################-----------
--------------------------------------------------
--------------------------------------------------
--------------------------------------------------
#########-----------T-----------------------------
--------------------------------------------------
---------------##########-------------------------
--------------------------------------------------
--------------------------------T-----------------
-----------------------------##########-----------
-------------------#------------------------------
-------------------#-----------------------#######
-------------------#------------------T-----------
---B-----------T---#------------------------------
##################################################