##################################################
--------------------------------------------------
--------------------------------------------------
--------------------------------------------------
--------------------------------------------------
--------------------------------------------------
--------------------------------------------------
--------------------------------------------------
--------------------------------------------------
--------------------------------------------------
--------------------------------------------------
--------------------------------------------------
--------------------------------------------------
--------------------------------------------------
--------------------------------------------------
--------------------------------------------------
--------------------------------------------------
-------------------------------------------T------
-----------------------T--------------------------
######------------------------------##############
---------------##################-----------------
--------------------------------------------------
--B---#-------------------------------------------
------#--------------------------------------L----
##################################################
